Date,Category,Revenue,Expenses,Profit,Profitability
2023-01-01,A,1000,500,500,0.5
2023-02-01,B,1200,600,600,0.5
2023-03-01,A,1100,550,550,0.5
2023-04-01,C,1300,650,650,0.5
2023-05-01,B,1400,700,700,0.5
2023-06-01,A,1500,750,750,0.5
2023-07-01,C,1600,800,800,0.5
2023-08-01,B,1700,850,850,0.5
2023-09-01,A,1800,900,900,0.5
2023-10-01,C,1900,950,950,0.5
